11111111111111111111
10001100000000100011
1111C000000000100001
1000000P000000100001
10000000000000100001
10000010000000010001
11111111111111111111
