11111111111111111111
10001100000000100011
11110000000000100001
1000000P00E000100001
10000000000000100001
10000010000000010001
11111111111111111111
