111111111111111111111111111111
100000000000000000000000000001
100000000000000000000000000001
1000000000000000000000000000C1
100000000000000000000000000001
100000000000000000000000000001
10000000000000000P000000000001
100000000000000000000000000001
100000000000000000000000000001
100000000000000000000000000001
10000000000X000000000000000001
100000000000000000000000000001
100000000000000000000000000001
10000000000000000000E0C0000001
100000000000000000000000000001
111111111111111111111111111111
